111111111111111111111
100000000000000000001
100000011100000000001
100000111110000000001
100000000000000000001
10000000N000000000001
111111111111111111111
