

F     200,25,0
C

1111111
1000001
1000101
1001 11
1111111


SE              path
WE



seoifhsepfioh seoifhsepfioh

WE path

