NO ./img/no_wall.xpm
SO ./img/so_wall.xpm
WE ./img/we_wall.xpm
EA ./img/ea_wall.xpm

F 0,124,0
C 0,0,155

  1
 1N1
11111
