NO ./img/no_wall.xpm
SO ./img/so_wall.xpm
WE ./img/we_wall.xpm
EA ./img/ea_wall.xpm

F 255,244,1
C 225,224,255

            1
           101
          10001
         1000001
        111101111
           101
           1N1
           101
        111101111
         1000001
          10001
           101
            1
